0,0,0,0,0,0,0,0,0,0,0,0,0,0,0,0,0,0,0,0,0,0,0,0,0,0,0,0,0,0,0,0,0,0,0
0,8,1,1,2,1,1,1,0,1,1,1,2,1,1,1,1,1,1,1,0,3,3,1,1,1,1,1,1,1,1,1,0,1,0
0,8,1,1,0,1,0,1,0,1,1,1,0,2,0,1,0,0,0,1,0,3,3,3,3,3,3,3,3,3,3,3,0,1,0
0,21,1,1,0,1,0,9,0,1,1,1,0,1,0,1,0,1,0,1,0,3,1,1,1,1,1,1,1,1,1,1,2,1,0
0,0,0,2,0,1,0,0,0,0,0,2,0,1,0,1,0,1,0,1,0,0,0,0,0,0,0,2,0,0,0,0,0,1,0
0,3,1,1,0,1,1,1,1,1,1,1,1,1,0,1,0,1,1,1,0,1,1,1,1,1,0,1,0,1,1,1,2,1,0
0,3,1,1,0,0,0,0,0,0,0,0,0,0,0,1,0,1,0,0,0,0,1,1,1,1,0,1,0,0,0,0,0,1,0
0,3,1,7,0,1,1,1,1,1,1,1,1,4,1,1,0,1,1,1,0,1,1,1,1,1,0,1,0,7,7,9,0,1,0
0,3,7,7,0,2,0,0,0,2,0,0,0,1,0,0,0,0,0,2,0,2,0,0,0,0,0,1,0,7,7,7,0,1,0
0,3,3,1,0,1,1,1,0,1,1,1,0,1,0,1,1,1,3,3,3,3,1,1,2,1,1,1,0,1,7,7,0,1,0
0,7,3,3,0,1,1,1,0,1,1,1,0,1,0,1,1,1,3,3,3,3,3,1,0,0,0,0,0,1,7,7,0,1,0
0,1,3,3,0,1,1,1,0,1,1,1,0,1,0,1,1,1,1,3,3,3,3,1,0,1,1,1,2,1,1,7,0,1,0
0,2,0,0,0,1,1,1,0,1,1,1,0,1,0,1,1,1,1,3,3,3,5,1,0,1,1,1,0,1,1,7,0,1,0
0,1,1,1,0,1,1,1,0,1,1,1,0,1,2,1,1,1,3,3,5,5,5,5,0,1,1,1,0,1,1,7,0,1,0
0,1,1,1,0,2,0,0,0,0,0,0,0,2,0,0,0,0,0,0,0,0,0,0,0,1,1,1,0,1,1,1,0,1,0
0,1,1,1,0,1,0,8,8,1,1,1,2,1,1,1,1,1,1,1,1,1,1,1,0,1,1,1,0,1,1,1,0,1,0
0,2,0,0,0,1,0,8,8,1,1,1,0,0,0,0,0,0,0,1,0,0,0,0,0,1,1,1,0,1,1,1,0,1,0
0,1,1,1,0,1,2,1,1,1,1,1,0,9,1,1,1,1,0,1,0,1,1,1,0,1,1,1,0,1,1,1,0,1,0
0,1,0,1,0,1,0,0,0,0,0,0,0,0,0,2,0,1,0,1,0,1,0,1,0,1,1,1,0,2,0,2,0,1,0
0,1,1,1,0,1,0,1,1,1,1,1,1,1,1,1,0,1,0,1,1,1,0,1,0,1,8,8,0,1,0,1,1,1,0
0,1,0,1,0,1,0,1,0,0,0,0,0,0,0,0,0,1,0,0,0,0,0,1,0,1,8,8,0,1,0,0,0,2,0
0,1,1,1,0,1,0,1,0,1,1,1,0,1,8,8,0,1,2,1,5,1,0,1,2,1,8,8,0,1,1,1,0,1,0
0,1,0,0,0,1,0,1,0,1,0,1,0,1,8,8,0,1,0,1,1,5,0,2,0,0,0,0,0,1,1,1,0,0,0
0,1,0,1,1,1,0,1,1,1,0,1,0,1,1,1,0,1,0,1,5,5,0,1,1,1,2,1,1,1,1,4,1,1,0
0,1,0,2,0,0,0,0,0,0,0,1,0,1,1,1,0,1,0,0,0,0,0,5,1,1,0,0,0,0,0,1,1,1,0
0,1,0,1,1,1,7,1,1,1,2,1,0,1,1,1,0,1,0,1,1,1,0,1,5,1,0,7,7,7,0,1,1,1,0
0,1,0,1,1,1,7,1,1,1,0,1,0,7,1,1,0,1,0,1,1,1,0,5,5,1,0,7,7,7,0,0,0,2,0
0,1,0,1,1,1,7,7,7,1,0,1,0,7,1,1,2,1,0,1,1,1,0,1,5,1,2,7,7,7,0,1,1,1,0
0,1,0,1,1,1,7,7,1,1,0,1,0,7,7,1,0,1,0,2,0,0,0,2,0,0,0,7,7,7,0,1,0,0,0
0,1,0,1,1,7,7,7,1,1,2,1,0,7,7,7,0,1,1,1,0,1,2,1,1,1,0,7,7,7,0,1,1,1,0
0,1,0,1,7,7,9,7,1,1,0,0,0,7,7,7,0,0,0,1,0,1,0,1,1,1,0,7,1,7,0,0,0,1,0
0,1,0,1,7,7,7,7,7,7,2,7,0,7,7,7,0,1,2,1,0,1,0,1,1,1,0,7,1,3,0,1,1,1,0
0,1,0,1,7,7,7,1,1,1,0,1,0,0,0,0,0,0,0,0,0,1,0,1,1,1,0,1,1,3,0,2,0,0,0
0,1,0,7,7,7,7,1,1,1,0,1,2,1,1,1,2,1,1,1,1,1,0,1,1,1,0,1,3,3,0,1,1,1,0
0,1,0,1,1,1,1,1,1,1,0,1,0,1,1,1,0,1,0,0,0,0,0,2,0,0,0,1,3,3,0,1,0,1,0
0,1,0,12,1,1,1,1,1,1,0,1,0,1,1,1,0,1,0,1,1,1,1,1,0,1,2,1,1,3,0,1,0,1,0
0,1,0,0,0,0,0,0,0,0,0,0,0,0,0,2,0,1,0,1,0,0,0,1,0,1,0,0,0,0,0,1,0,1,0
0,1,0,1,2,9,0,1,2,1,1,1,0,1,1,1,0,1,0,1,1,1,0,1,0,1,1,1,0,1,2,1,1,1,0
0,1,0,1,0,0,0,1,0,1,1,1,0,1,0,1,0,1,0,0,0,1,0,1,0,0,0,1,0,0,0,1,1,1,0
0,1,0,1,2,1,0,1,0,1,1,1,0,1,1,1,2,1,1,1,0,1,0,1,1,1,1,1,1,1,0,1,1,1,0
0,1,0,1,0,0,0,1,0,2,0,0,0,0,0,0,0,0,0,1,0,1,0,0,0,0,0,0,0,1,0,1,1,1,0
0,1,1,1,2,8,8,8,0,1,1,1,1,1,0,1,1,1,1,1,0,1,0,1,1,1,8,8,0,1,0,1,1,1,0
0,1,1,1,0,8,8,8,0,1,1,1,1,1,0,1,0,0,0,0,0,1,0,1,1,1,8,8,0,1,0,0,0,2,0
0,1,1,1,0,8,8,8,0,1,1,1,1,1,2,1,1,1,1,1,1,1,2,1,1,6,8,8,2,1,1,1,1,1,0
0,0,0,0,0,0,0,0,0,0,0,0,0,0,0,0,0,0,0,0,0,0,0,0,0,0,0,0,0,0,0,0,0,0,0