0,0,0,0,0,0,0,0,0,0,0,0,0,0,0,0,0,0,0,0,0,0,0,0,0,0,0,0,0,0,0,0,0,0,0
0,1,1,12,0,1,1,1,0,1,1,1,0,1,1,1,1,1,1,1,0,1,1,1,2,1,2,1,1,1,0,1,1,1,0
0,1,0,0,0,1,1,1,0,1,1,1,0,1,1,1,1,1,1,1,0,1,1,1,0,1,0,1,1,1,0,1,1,1,0
0,1,2,1,1,1,1,1,0,1,1,1,0,1,1,1,1,1,1,1,0,1,1,1,0,1,0,1,1,1,0,1,1,1,0
0,1,0,1,1,1,1,1,0,1,1,1,0,1,1,1,1,1,1,1,0,1,1,1,0,1,0,1,1,1,0,1,1,1,0
0,1,0,1,1,1,1,1,0,1,1,1,0,1,1,1,1,1,1,1,0,1,1,1,0,1,0,1,1,1,2,1,1,1,0
0,1,0,0,0,2,0,1,0,1,1,1,0,1,1,1,1,1,1,1,0,1,1,1,0,0,0,1,1,1,0,1,1,1,0
0,1,1,1,1,1,0,1,0,1,1,1,0,1,1,1,1,1,1,1,2,1,1,1,1,1,0,1,1,1,0,1,1,1,0
0,0,0,1,1,1,0,2,0,2,0,2,0,0,0,0,0,1,0,0,0,0,0,0,0,1,0,0,0,0,0,1,1,1,0
0,1,1,1,1,1,2,1,1,1,0,1,1,1,1,1,1,1,2,1,1,1,1,1,0,1,0,0,0,1,2,1,1,1,0
0,1,0,0,0,0,0,1,1,1,0,1,1,1,1,1,1,1,0,1,1,1,1,1,0,2,0,0,0,2,0,0,0,2,0
0,1,1,1,1,1,0,1,1,1,0,1,1,1,1,1,1,1,0,1,1,1,1,1,0,1,1,1,0,1,1,1,0,1,0
0,0,0,0,0,2,0,0,0,0,0,0,0,2,0,0,0,2,0,1,1,1,1,1,0,1,1,1,0,1,1,1,0,1,0
0,1,1,1,0,1,1,1,1,1,1,1,1,1,1,1,0,1,0,1,1,1,1,1,0,1,1,1,1,1,1,1,0,1,0
0,1,1,1,0,1,1,1,1,1,1,1,1,1,1,1,0,1,0,1,1,1,1,1,0,1,1,1,0,0,0,0,0,1,0
0,1,1,1,2,1,1,1,1,1,1,1,1,1,1,1,0,1,0,1,1,1,1,1,0,1,1,1,0,1,1,1,0,1,0
0,2,0,0,0,1,1,1,1,1,1,1,1,1,1,1,0,1,0,1,1,1,1,1,0,1,1,1,0,1,1,1,0,1,0
0,1,0,0,0,1,1,1,1,1,1,1,1,1,1,1,0,1,0,1,1,1,1,1,1,1,1,1,0,1,1,1,2,1,0
0,1,0,0,0,2,0,0,0,0,0,2,0,0,0,0,0,1,0,1,1,1,1,1,0,1,1,1,0,1,1,1,0,0,0
0,1,0,1,1,1,1,1,2,1,1,1,1,1,1,1,2,1,0,1,1,1,1,1,0,1,1,1,0,1,1,1,0,0,0
0,1,0,1,1,1,1,1,0,1,1,1,1,1,1,1,0,0,0,0,0,0,0,0,0,1,1,1,0,1,1,1,0,0,0
0,1,0,1,1,1,1,1,0,1,1,1,1,1,1,1,1,1,1,1,0,1,1,1,0,1,1,1,0,1,1,1,2,1,0
0,1,0,1,1,1,1,1,0,1,1,1,1,1,1,1,0,1,1,1,0,2,0,0,0,0,0,2,0,0,0,0,0,2,0
0,1,0,1,1,1,1,1,0,1,1,1,1,1,1,1,0,1,1,1,0,1,1,1,1,1,0,1,1,1,0,1,1,1,0
0,2,0,0,0,2,0,0,0,2,0,0,0,0,0,2,0,1,1,1,0,1,1,1,1,1,0,1,1,1,0,1,1,1,0
0,1,1,1,1,1,1,1,1,1,1,1,0,1,1,1,2,1,1,1,1,1,1,1,1,1,0,1,1,1,0,1,1,1,0
0,1,1,1,1,1,1,1,1,1,1,1,0,1,1,1,0,0,0,2,0,1,1,1,1,1,0,1,1,1,0,1,1,1,0
0,1,1,1,1,1,1,1,1,1,1,1,0,1,1,1,2,1,0,1,2,1,1,1,1,1,2,1,1,1,0,1,1,1,0
0,1,1,1,1,1,1,1,1,1,1,1,0,1,1,1,0,1,0,1,0,1,1,1,1,1,0,1,1,1,0,1,1,1,0
0,1,1,1,1,1,1,1,1,1,1,1,0,1,1,1,0,1,0,1,2,1,1,1,1,1,0,1,1,1,0,1,1,1,0
0,1,1,1,1,1,1,1,1,1,1,1,0,1,1,1,0,1,0,1,0,1,1,1,1,1,0,1,1,1,0,1,1,1,0
0,1,1,1,1,1,1,1,1,1,1,1,1,1,1,1,0,1,0,1,0,1,1,1,1,1,0,1,1,1,0,1,1,1,0
0,1,1,1,1,1,1,1,1,1,1,1,0,1,1,1,0,2,0,0,0,1,1,1,1,1,0,0,0,0,0,0,0,2,0
0,1,1,1,1,1,1,1,1,1,1,1,0,1,1,1,0,1,1,1,2,1,1,1,1,1,2,1,1,1,0,1,1,1,0
0,21,0,2,0,0,0,0,0,0,0,1,0,2,0,0,0,1,1,1,0,0,0,0,0,0,0,1,1,1,0,1,1,1,0
0,0,0,1,1,1,1,1,2,1,1,1,0,1,1,1,2,1,1,1,0,1,1,1,1,1,1,1,1,1,0,1,1,1,0
0,1,0,1,1,1,1,1,0,1,1,1,0,0,0,0,0,0,0,0,0,0,0,0,0,1,0,1,1,1,0,1,1,1,0
0,1,0,1,1,1,1,1,0,1,1,1,0,1,1,1,1,1,0,1,1,1,1,1,0,1,0,1,1,1,0,1,1,1,0
0,1,0,1,1,1,1,1,0,1,1,1,0,1,1,1,1,1,0,1,0,1,1,1,0,1,0,1,1,1,0,1,1,1,0
0,1,2,1,1,1,1,1,0,1,1,1,0,1,1,1,1,1,0,1,0,1,1,1,2,1,0,1,1,1,2,1,1,1,0
0,0,0,0,0,2,0,0,0,1,1,1,0,1,1,1,1,1,0,1,0,0,0,0,0,0,0,1,1,1,0,0,0,2,0
0,1,1,1,1,1,1,1,0,1,1,1,0,1,1,1,1,1,0,1,0,1,1,1,1,1,2,1,1,1,2,1,1,1,0
0,1,1,1,1,0,0,1,0,0,0,0,0,2,0,2,0,0,0,1,0,1,0,0,0,0,0,0,0,0,0,1,1,1,0
0,12,1,1,1,0,0,1,1,1,1,1,1,1,0,1,1,1,1,1,1,1,0,0,0,0,0,0,0,0,0,1,1,1,0
0,0,0,0,0,0,0,0,0,0,0,0,0,0,0,0,0,0,0,0,0,0,0,0,0,0,0,0,0,0,0,0,0,0,0